Gs^Ftp, Gs^Ftp, Gs^Ftp, Gs^Ftp, Gs^Ftp, Gs^Ftp, Gs^Ftp, Gs^Ftp, Gd^Fts, Gs^Ftp, Gs^Ftp, Gs^Ftp, Gd^Fts, Gs^Ftp, Gd^Fts, Gd^Fts, Gd^Fts, Dd, Dd, Dd, Gd, Dd, Dd, Dd, Dd, Gd, Dd, Dd, Dd, Dd, Dd, Dd, Dd, Dd, Dd, Dd, Dd, Dd, Dd, Dd, Dd, Dd, Dd, Dd, Dd, Dd
Gs^Ftp, Gs^Ftp, Gs^Ftp, Gs^Ftp, Gs^Ftp, Gd, Gs^Ftp, Gd^Fts, Gs^Ftp, Gs^Ftp, Gd^Fts, Gs^Ftp, Gd^Fts, Gs^Ftp, Gd^Fts, Gd^Fts, Gd, Gd^Fts, Dd, Dd, 2 Gd, Dd, Gd, Dd, Dd, Gd, Gd, Dd, Dd, Dd, Dd, Dd, Dd, Dd, Dd, Dd, Dd, Dd, Dd, Dd, Dd, Dd, Dd, Dd, Dd, Dd
Gs^Ftp, Gs^Ftp, Gs^Ftp, Gs^Ftp, Gs^Ftp, Gs^Ftp, Gd, Gs^Ftp, Gs^Ftp, Gs^Ftp, Gs^Ftp, Gs^Ftp, Gd^Fts, Gs^Ftp, Gd^Fts, Gd, Gd^Fts, Gd^Fts, Gd^Fts, Dd, Gd, Dd, Dd, Dd, Gd, Dd, Gd, Dd, Dd, Dd, Dd, Dd, Dd, Dd, Dd, Dd, Dd, Dd, Dd, Dd, Dd, Dd, Dd, Dd, Dd, Dd
Gs^Ftp, Gd, Gs^Ftp, Gs^Ftp, Gs^Ftp, Gs^Ftp, Gs^Ftp, Gs^Ftp, Gd^Fts, Gd, Gs^Ftp, Gs^Ftp, Gs^Ftp, Gs^Ftp, Gs^Ftp, Gd^Fts, Dd, Gd^Fts, Gd, Dd, Gd, Dd, Gd, Dd, Gd, Gd, Gd, Gd, Dd, Dd, Dd, Dd, Dd, Dd, Dd, Dd, Dd, Dd, Dd, Dd, Dd, Dd, Dd, Dd, Dd, Dd
Gs^Ftp, Gs^Ftp, Gs^Ftp, Gs^Ftp, Gs^Ftp, Gd, Gs^Ftp, Gd, Gs^Ftp, Gd^Fts, Gs^Ftp, Gs^Ftp, Gs^Ftp, Gs^Ftp, Gs^Ftp, Gd^Fts, Gd^Fts, Gd, Gd, Dd, Gd, Dd, Gd, Gd, Dd, Dd, Gd, Dd, Dd, Dd, Dd, Dd, Dd, Dd, Dd, Dd, Dd, Dd, Dd, Dd, Dd, Dd, Dd, Dd, Dd, Dd
Gs^Ftp, Gs^Ftp, Gs^Ftp, Gd, Gd, Gs^Ftp, Gd, Gs^Ftp, Gs^Ftp, Gs^Ftp, Gd, Gs^Ftp, Gs^Ftp, Gs^Ftp, Gs^Ftp, Gd, Gd^Fts, Gd^Fts, Gd, Gd, Dd, Gd, Gd, Dd, Dd, Dd, Gd, Dd, Dd, Dd, Dd, Dd, Dd, Dd, Dd, Dd, Dd, Dd, Dd, Dd, Dd, Dd, Dd, Dd, Dd, Dd
Gs^Ftp, Gs^Ftp, Gs^Ftp, Gs^Ftp, Gs^Ftp, Gs^Ftp, Gs^Ftp, Gs^Ftp, Gs^Ftp, Gs^Ftp, Gd^Fts, Gs^Ftp, Gd^Fts, Gs^Ftp, Gd^Fts, Gd, Gd^Fts, Gd^Fts, Gd^Fts, Dd, Gd, Gd, Gd, Gd, Dd, Dd, Gd, Dd, Dd, Gd, Gd, Dd, Dd, Dd, Dd, Dd, Dd, Dd, Dd, Dd, Dd, Dd, Dd, Dd, Dd, Dd
Gs^Ftp, Gs^Ftp, Gs^Ftp, Gs^Ftp, Gs^Ftp, Gs^Ftp, Gd, Gs^Ftp, Gs^Ftp, Gs^Ftp, Gs^Ftp, Gs^Ftp, Gd, Gs^Ftp, Gs^Ftp, Gd^Fts, Gd^Fts, Gd, Hd, Hd, Hd, Gd, Gd, Gd, Hd, Dd, Gd, Hd, Gd, Dd, Dd, Gd, Dd, Dd, Dd, Dd, Dd, Dd, Dd, Dd, Dd, Dd, Dd, Dd, Dd, Dd
Gs^Ftp, Gd, Gs^Ftp, Gs^Ftp, Gs^Ftp, Gs^Ftp, Gs^Ftp, Gs^Ftp, Gs^Ftp, Gs^Ftp, Gs^Ftp, Gs^Ftp, Gd^Fts, Hd, Gd^Fts, Gd^Fts, Gd, Gd, Gd, Gd, Gd, Dd, Gd, Dd, Hd, Hd, Mdd, Hd, Dd, Gd^Dr, Dd, Dd, Hd, Dd, Hd, Dd, Dd, Dd, Dd, Dd, Dd, Dd, Dd, Dd, Dd, Dd
Gs^Ftp, Gs^Ftp, Gs^Ftp, Gs^Ftp, Gs^Ftp, Gs^Ftp, Gs^Ftp, Gd, Gs^Ftp, Gd^Fts, Gs^Ftp, Gs^Ftp, Gd^Fts, Hd, Hd, Hd, Hd, Hd, Hd, Hd, Hd, Hd, Hd, Gd, Hd, Mdd, Mdd^Xm, Hd, Hd, Hd, Dd, Hd, Hd, Hd, Dd, Dd, Hhd, Dd, Dd, Dd, Dd, Dd, Dd, Dd, Dd, Dd
Gs^Ftp, Gs^Ftp, Gs^Ftp, Gs^Ftp, Gs^Ftp, Gs^Ftp, Gd, Gd, Hd, Gd^Fts, Gd, Hd, Gd^Fts, Hd, Hd, Gd^Fts, Hd, Hd, Mdd, Mdd, Mdd, Mdd, Hd, Gd, Gd, Mdd, Mdd, Mdd, Hd, Hd, Hd, Hd, Gd, Hd, Hd, Dd, Dd, Hhd, Dd, Dd, Dd, Dd, Dd, Dd, Dd, Dd
Gs^Ftp, Gs^Ftp, Gd, Gs^Ftp, Gs^Ftp, Gs^Ftp, Gs^Ftp, Gs^Ftp, Gs^Ftp, Gd^Fts, Gs^Ftp, Hd, Mdd, Gd^Fts, Hd, Hd, Hd, Hd, Hd, Mdd, Mdd, Hd, Mdd, Dd, Gd, Hd, Hd, Hd, Hd, Gd, Hd, Hd, Mdd, Gd, Hd, Hd, Dd, Hhd, Dd, Dd, Dd, Dd, Dd, Dd, Dd, Dd
Gs^Ftp, Gs^Ftp, Gs^Ftp, Gs^Ftp, Gs^Ftp, Gs^Ftp, Gd^Fts, Gd^Fts, Gd^Fts, Gs^Ftp, Gs^Ftp, Gs^Ftp, Gs^Ftp, Gs^Ftp, Mdd, Mdd, Hd, Hd, Mdd^Xm, Mdd^Xm, Mdd^Xm, Mdd, Mdd, Gd, Gd, Gd, Hd, Hd, Mdd, Hd, Hd, Mdd, Mdd, Hd, Hd, Hd, Hd, Dd, Hd, Hd, Hd, Gd^Dr, Dd, Dd, Dd, Dd
Gs^Ftp, Gs^Ftp, Gs^Ftp, Gs^Ftp, Gd, Gs^Ftp, Gs^Ftp, Gs^Ftp, Gs^Ftp, Mdd, Gd^Fts, Gs^Ftp, Gs^Ftp, Mdd, Mdd, Mdd, Mdd^Xm, Mdd^Xm, Mdd^Xm, Mdd^Xm, Mdd^Xm, Mdd^Xm, Mdd, Gd^Fts, Gd, Dd, Mdd, Mdd, Mdd^Xm, Mdd, Mdd, Hd, Mdd, Mdd, Mdd, Mdd, Mdd, Hd, Hd, Dd, Dd, Hd, Hd, Dd, Dd, Dd
Gs^Ftp, Gs^Ftp, Gs^Ftp, Gs^Ftp, Gd^Fts, Gd^Fts, Gs^Ftp, Gs^Ftp, Gs^Ftp, Gd^Fts, Gs^Ftp, Gd^Fts, Gd^Fts, Gd^Fts, Mdd, Mdd, Mdd, Mdd^Xm, Mdd^Xm, Mdd^Xm, Gs^Ftp, Gs^Ftp, Gs^Ftp, Gd^Fts, Gd^Fts, Hhd, Hhd, Mdd, Mdd^Xm, Mdd^Xm, Xue, Mdd^Xm, Xue, Mdd^Xm, Mdd^Xm, Mdd, Mdd^Xm, Hd, Mdd, Hd, Dd, Hd, Hd, Dd, Dd, Dd
Gs^Ftp, Gd, Gs^Ftp, Gs^Ftp, Gd^Fts, Gs^Ftp, Gs^Ftp, Gd, Hd, Gd^Fts, Gs^Ftp, Gs^Ftp, Gd^Fts, Gd^Fts, Gd^Fts, Mdd, Hhd, Mdd^Xm, Gs^Ftp, Gs^Ftp, Rp, Gs^Ftp, Gs^Ftp, Gd^Fts, Gd, Gd^Fts, Hhd, Mdd, Mdd, Mdd, Mdd^Xm, Xue, Wot, Xue, Xue, Mdd^Xm, Mdd^Xm, Mdd, Mdd, Dd, Hd, Dd, Dd, Dd, Dd, Dd
Gd^Fts, Gs^Ftp, Gd^Fts, Gd^Fts, Gs^Ftp, Gs^Ftp, Gs^Ftp, Gs^Ftp, Gd^Fts, Gd^Fts, Mdd, Gs^Ftp, Gs^Ftp, Gs^Ftp, Hhd, Gd^Fts, Gd^Fts, Gd^Fts, Gd^Fts, Gs^Ftp, Gs^Ftp, Rp, Gd, Gd^Fts, Gd, Gd, Wwt, Hhd, Mdd, Mdd, Wot, Wot, Wot, Wot, Xue, Mdd^Xm, Mdd^Xm, Mdd, Hd, Hd, Dd, Dd, Dd, Dd, Dd, Dd
Gs^Ftp, Gd^Fts, Gs^Ftp, Gd^Fts, Hd, Gd^Fts, Gs^Ftp, Gd^Fts, Gd^Fts, Hd, Hd, Mdd, Mdd, Hhd, Hhd, Hhd, Hhd, Gd, Gd^Fts, Gd^Fts, Gs^Ftp, Gd^Fts, Gd, Gd, Gd, Gd, Ww, Ww, Ww, Wwt, Mdd, Wot, Wot, Xue, Mdd^Xm, Mdd^Xm, Mdd, Mdd, Hd, Hd, Dd, Dd, Dd, Dd, Dd, Dd
Gs^Ftp, Gs^Ftp, Gs^Ftp, Gs^Ftp, Gs^Ftp, Gs^Ftp, Gd^Fts, Hd, Gd, Gd^Fts, Hd, Mdd, Mdd, Mdd, Mdd^Xm, Mdd^Xm, Mdd, Hhd, Gd, Gd^Fts, Hhd, Gd^Fts, Gd, Gd, Gd, Wwt, Ww, Ww, Ww, Mdd, Mdd, Mdd^Xm, Mdd^Xm, Mdd^Xm, Mdd, Mdd, Hd, Mdd, Mdd, Hd, Dd, Dd, Hd, Dd, Dd, Dd
Gd, Gd^Fts, Gd^Fts, Gd, Gs^Ftp, Gs^Ftp, Gd^Fts, Mdd, Mdd, Gd^Fts, Gd^Fts, Hd, Mdd, Mdd, Mdd^Xm, Mdd, Mdd, Hhd, Hhd, Gd, Gd, Gd, Gd^Fts, Gd, Gd^Fts, Gd, Wwt, Ww, Gd, Hd, Mdd, Mdd^Xm, Mdd, Mdd, Mdd, Hd, Hd, Mdd, Hd, Hd, Dd, Dd, Dd, Dd, Dd, Dd
Gs^Ftp, Gs^Ftp, Gd, Gs^Ftp, Gd^Fts, Gd^Fts, Hd, Mdd, Hd, Gd, Gd^Fts, Hd, Hd, Mdd, Mdd^Xm, Mdd^Xm, Mdd^Xm, Mdd, Mdd, Hhd, Gd^Fts, Gd^Fts, Hhd, Gd^Fts, Hhd, Hhd, Gd, Wwt, Wwt, Gd, Hd, Mdd, Hd, Mdd, Hd, Hd, Dd, Hd, Dd, Hd, Dd, Hd, Dd, Dd, Dd, Dd
Gs^Ftp, Gs^Ftp, Gs^Ftp, Gs^Ftp, Gd^Fts, Gs^Ftp, Gs^Ftp, Gd, Gs^Ftp, Gd^Fts, Hd, Hd, Mdd, Mdd, Mdd, Mdd^Xm, Mdd^Xm, Mdd^Xm, Mdd^Xm, Mdd, Mdd, Hhd, Mdd, Hhd, Mdd, Hhd, Hhd, Gd, Wwt, Gd, Gd, Hd, Hd, Hd, Hd, Dd, Dd, Dd, Dd, Dd, Dd, Dd, Dd, Dd, Dd, Dd
Gd^Fts, Gd^Fts, Gs^Ftp, Gd^Fts, Gd^Fts, Gd^Fts, Gd^Fts, Gs^Ftp, Hd, Gs^Ftp, Gd^Fts, Gd^Fts, Hd, Hd, Mdd, Mdd, Mdd, Mdd^Xm, Mm^Xm, Mdd^Xm, Mdd^Xm, Mdd, Mdd^Xm, Mdd, Mdd^Xm, Mdd^Xm, Mdd, Gd, Gd, Wwt, Ww, Gd, Gd, Gd, Hd, Hd, Dd, Hhd^Vhhr, Hhd, Dd, Dd, Dd, Dd, Dd, Dd, Dd
Gd, Gs^Ftp, Gd^Fts, Gd^Fts, Gd, Gd, Gd^Fts, Hd, Gd, Gd^Fts, Gd^Fts, Hd, Hd, Mdd, Hd, Mdd, Mdd, Mdd^Xm, Mdd, Mdd^Xm, Mdd^Xm, Mdd^Xm, Mdd^Xm, Mdd^Xm, Mdd^Xm, Mdd, Mdd, Hhd, Hhd, Gd, Wwt, Gd, Hd, Hd, Dd, Dd, Hd, Hd, Dd, Dd, Dd, Dd, Dd, Dd, Dd, Dd
Gs^Ftp, Gs^Ftp, Gd^Fts, Gd^Fts, Gd^Fts, Gd^Fts, Gd, Gd, Hd, Gd, Gd, Hd, Hd, Gd, Gd, Hd, Hd, Mdd, Hd, Mdd, Hd, Mdd^Xm, Mdd^Xm, Mdd^Xm, Mdd, Mdd, Hd, Hd, Hhd, Gd, Wwt, Gd, Gd, Hd, Dd, Dd, Dd, Gd, Dd, Dd, Dd, Dd, Dd, Dd, Dd, Dd
Gs^Ftp, Gs^Ftp, Gd^Fts, Gd, Gd^Fts, Gd, Gd, Gd, Gd, Gd, Gd, Gd, Gd, Hd, Gd, Hd, Hd, Mdd, Hd, Hd, Mdd, Mdd, Hd, Mdd, Hd, Mdd, Hd, Hd, Hd, Wwt, Gd, Gd, Gd, Gd, Dd, Dd, Dd, Dd, Dd, Dd, Dd, Dd, Dd, Dd, Dd, Dd
Gd^Fts, Gd, Gd^Fts, Gd^Fts, Gd, Gd, Gd, Gd, Gd, Gd, Gd, Gd, Gd, Gd, Gd, Hd, Hd, Hd, Hd, Hd, Hd, Hd, Hd, Mdd, Hd, Hd, Hd, Hd, Hd, Wwt, Wwt, Gd, Hhd, Gd, Dd, Dd, Dd, Dd, Dd, Dd, Dd, Dd, Dd, Dd, Dd, Dd
Gd^Fts, Gs^Ftp, Gd^Fts, Gd, Gd, Gd, Gd, Gd, Gd, Gd, Hd, Gd, Gd, Gd, Gd, Hd, Hd, Gd, Hd, Hd, Hd, Gd, Gd, Hd, Hd, Hd, Hd, Hd, Gd, Gd, Wwt, Gd, Gd, Gd, Dd, Dd, Dd, Dd, Dd, Dd, Dd, Dd, Dd, Dd, Dd, Dd
Gd, Gd^Fts, Gd^Fts, Gd, Gd, Gd, Gd, Gd, Gd, Gd, Gd, Hd, Gd, Gd, Gd, Hd, Hd, Gd, Gd, Gd, Gd, Gd, Gd, Gd, Gd, Gd, Gd, Gd, Gd, Gd^Dr, Wwt, Gd, Gd, Gd, Dd, Dd, Dd, Dd, Dd, Dd, Dd, Dd, Dd, Dd, Dd, Dd
Gs^Ftp, Gs^Ftp, Gd, Gd, Gd, Gd, Gd, Gd, Gd, Gd, Gd, Gd, Gd, Gd, Gd, Gd, Gd, Hd, Gd, Gd, Gd, Gd, Hhd, Gd, Gd, Gd, Hhd, Gd, Gd, Gd, Gd, Wwt, Gd, Dd, Dd, Dd, Dd, Dd, Dd, Dd, Dd, Dd, Dd, Dd, Dd, Gd
Gd^Fts, Gd^Fts, Gd, Gd, Gd, Gd, Gd, Gd, Gd, Gd, Gd, Gd, Gd, Gd, Gd, Gd, Gd, Gd, Gd, Gd, Gd, Gd, Gd, Gd, Gd, Gd, Gd, Gd, Gd, Gd, Gd, Ww, Gd, Dd, Dd, Dd, Dd, Dd, Dd, Dd, Dd, Dd, Dd, Dd, Dd, Dd
Gd, Gd, Gd, Gd, Gd, Gd, Gd, Gd, Gd, Gd, Gd, Gd, Gd, Gd, Gd, Gd, Gd, Gd, Gd, Gd, Gd, Gd, Gd, Gd, Gd, Gd, Gd, Gd, Gd, Gd, Ww, Ww, Gd, Gd, Gd, Dd, Gd, Dd, Gd, Dd, Dd, Dd, Dd, Dd, Dd, Dd
Gd, Gd, Gd, Gd, Gd, Gd, Gd, Gd, Gd, Gd, Gd, Gd, Gd, Gd, Gd, Gd, Gd, Gd, Gd, Gd, Gd, Gd, Gd, Gd, Gd, Gd, Gd, Gd, Gd, Gd, Ww, Gd, Gd, Gd, Gd, Gd^Dr, Dd, Dd, Dd, Dd, Dd, Dd, Dd, Dd, Dd, Gd
Gd, Gd, Gd, Gd, Gd, Gd, Gd, Gd, Gd, Gd, Gd, Gd, Gd, Gd, Gd, Gd, Gd, Gd, Gd, Gd, Gd, Gd, Gd, Gd, Gd, Gd, Gd, Gd, Gd, Gd, Gd, Ww, Ww, Gd, Gd, 1 Gd, Dd, Dd, Dd, Dd, Dd, Dd, Dd, Dd, Dd, Dd
Gd, Gd, Gd, Gd, Gd, Gd, Gd, Gd, Gd, Gd, Gd, Gd, Gd, Gd, Gd, Gd, Gd, Gd, Gd, Gd, Gd, Gd, Gd, Gd, Gd, Gd, Gd, Gd, Gd, Gd, Gd, Gd, Ww, Gd, Ww, Gd, Dd, Dd, Dd, Dd, Gd, Dd, Dd, Dd, Dd, Dd
